1111111111111
1C10000000101
1100000000011
1000001P100E1
1111111111111