11111111111
10000EC0001
1E000000P11
11111111111